4 13 31
###############################
#p    *s***    *3  *     *   *#
# # # # #*# # #*#*# # # # # # #
#   *   3***** * ***          #
# # #*# # # #*#1#*# #*#*# #*#2#
#   * f *     ****  ****      #
# # # # # # # # # # # # #*# #*#
#   x  **   4 *  f     * *    #
# # # # # # # # # # # # #*#*# #
#   2   *     *  *  **     *  #
# #*# # # # # # #*# # #5# #*# #
#      *  *     *       *  *  #
###############################
