13 31
###############################
#p     ** *  3 * 2 *  * * *   #
#                             #
#  x*     ***  *  1   * 2 * * #
#**************************** #
#f         x **  *  *   5     #
#             *               #
#*  * 2    ****      *        #
#          **4*               #
#*    **  *  4    *  p        #
#                             #
#           *   *  *          #
###############################