13 31
###############################
#p    *s*** x  *   *1    *   *#
# # # # #*# # #*#*# # # # # # #
#   *  ##***** * ***    4  #  #
# # #*# # # #*# #*# #*#*# #*# #
#   *   *f***2****  ****   3  #
# # # # # # # # # # # # #*# #*#
#   f  *b   * *4    #  * * 5  #
# # # # # # # #f# # # # #*#*# #
#       *  ## *  * 4**     *  #
# #*# # # # # # #*# # # # #*# #
#  3   *  *   5 *x   ## *  *  #
###############################
