13 31
###############################
#p    *s*** x  *   *1    *   *#
# # # # #*# # #*#*# # # # # # #
#  f*    ***** * ***    4     #
# # #*# # # #*# #*# #*#*# #*# #
#   *   *     ****  ****   3  #
# # # # # # # # # # # # #*# #*#
#      **f    *4       * * 5  #
# # # # # # # # # # # # #*#*# #
#       *     *  * 2**     *  #
# #*# # # # # # #*# # # # #*# #
#      *  *   2 *1      *  *  #
###############################
